Date,Week,Backlog of visa applications - Homes for Ukraine,Backlog of visa applications - Family Scheme,Backlog of visa applications - Super Sponsor,Backlog of visas issued - Homes for Ukraine,Backlog of visas issued - Family Scheme,Backlog of visas issued - Super Sponsor,Backlog of visas issued - Homes for Ukraine (upper bound),Backlog of visas issued - Family Scheme (upper bound),Backlog of visas issued - Super Sponsor (upper bound),Backlog of visas issued - Homes for Ukraine (lower bound),Backlog of visas issued - Family Scheme (lower bound),Backlog of visas issued - Super Sponsor (lower bound),Weekly applications - Homes for Ukraine,Weekly applications - Family Scheme,Arrival rate - Homes for Ukraine,Arrival rate - Family Scheme,Arrival rate - Super Sponsor,Arrival rate - Homes for Ukraine (upper bound),Arrival rate - Family Scheme (upper bound),Arrival rate - Super Sponsor (upper bound),Arrival rate - Homes for Ukraine (lower bound),Arrival rate - Family Scheme (lower bound),Arrival rate - Super Sponsor (lower bound),Weekly arrivals - Homes for Ukraine,Weekly arrivals - Family Scheme,Weekly arrivals - Super Sponsor,Weekly arrivals - Homes for Ukraine (upper bound),Weekly arrivals - Family Scheme (upper bound),Weekly arrivals - Super Sponsor (upper bound),Weekly arrivals - Homes for Ukraine (lower bound),Weekly arrivals - Family Scheme (lower bound),Weekly arrivals - Super Sponsor (lower bound),Weekly arrivals,Weekly arrivals (upper bound),Weekly arrivals (lower bound),Total arrivals,Total arrivals (upper bound),Total arrivals (lower bound)
2022-12-12,50,18736,16675,7499,23904,19564,14781,24358,19830,14991,23106,19297,14572,1450,1032,0.02047434873148558,0.03260178607627402,0.03260178607627402,0.056408109139547455,0.04726094181521865,0.04726094181521865,0,0.017942630337329395,0.017942630337329395,454,593,467,1252,860,676,0,327,257,1514,2788,584,150675,151949,149745
2022-12-19,51,18071,15847,6665,25578,20780,15133,26441,21338,15564,23907,20214,14698,1418,1026,0.017126892494755287,0.03260178607627402,0.03260178607627402,0.0526442436828122,0.04726094181521865,0.04726094181521865,0,0.017942630337329395,0.017942630337329395,409,638,482,1282,937,708,0,346,261,1529,2927,607,152204,154876,150352
2022-12-26,52,17448,15105,5924,27235,21865,15381,28450,22737,16041,24624,20968,14703,1386,1020,0.01377943625802499,0.03260178607627402,0.03260178607627402,0.04888037822607696,0.04726094181521865,0.04726094181521865,0,0.017942630337329395,0.017942630337329395,352,677,493,1292,1008,736,0,363,264,1522,3036,627,153726,157912,150979
2023-01-02,53,16862,14440,5265,28891,22831,15539,30390,24040,16436,25280,21572,14604,1354,1014,0.010431980021294694,0.03260178607627402,0.03260178607627402,0.0451165127693417,0.04726094181521865,0.04726094181521865,0,0.017942630337329395,0.017942630337329395,284,713,501,1284,1075,758,0,376,264,1498,3117,640,155224,161029,151619
2023-01-09,54,16310,13843,4680,30560,23692,15617,32264,25258,16759,25897,22041,14412,1322,1008,0.007084523784564398,0.03260178607627402,0.03260178607627402,0.04135264731260643,0.04726094181521865,0.04726094181521865,0,0.017942630337329395,0.017942630337329395,205,744,507,1257,1136,777,0,387,262,1456,3170,649,156680,164199,152268
2023-01-16,55,15788,13306,4160,32259,24459,15628,34077,26402,17020,26497,22386,14140,1291,1002,0.003737067547834102,0.03260178607627402,0.03260178607627402,0.03758878185587119,0.04726094181521865,0.04726094181521865,0,0.017942630337329395,0.017942630337329395,114,772,509,1213,1194,792,0,395,259,1395,3199,654,158075,167398,152922
2023-01-23,56,15292,12823,3698,34001,25141,15580,35832,27479,17228,27099,22617,13798,1259,996,3.896113111038061e-4,0.03260178607627402,0.03260178607627402,0.03382491639913593,0.04726094181521865,0.04726094181521865,0,0.017942630337329395,0.017942630337329395,13,797,510,1153,1248,804,0,402,254,1320,3205,656,159395,170603,153578
2023-01-30,57,14819,12388,3287,35701,25746,15483,37532,28498,17391,27722,22743,13395,1227,990,0,0.03260178607627402,0.03260178607627402,0.030061050942400667,0.04726094181521865,0.04726094181521865,0,0.017942630337329395,0.017942630337329395,0,820,508,1077,1299,814,0,406,248,1328,3190,654,160723,173793,154232
2023-02-06,58,14367,11995,2922,37348,26284,15343,39179,29467,17516,28382,22773,12938,1195,984,0,0.03260178607627402,0.03260178607627402,0.02629718548566542,0.04726094181521865,0.04726094181521865,0,0.017942630337329395,0.017942630337329395,0,839,505,987,1347,822,0,408,240,1344,3156,648,162067,176949,154880
2023-02-13,59,13933,11640,2597,38945,26760,15168,40776,30391,17609,29096,22713,12435,1163,978,0,0.03260178607627402,0.03260178607627402,0.022533320028930166,0.04726094181521865,0.04726094181521865,0,0.017942630337329395,0.017942630337329395,0,857,500,883,1393,828,0,409,232,1357,3104,641,163424,180053,155521
2023-02-20,60,13515,11318,2308,40494,27182,14962,42325,31277,17675,29880,22571,11892,1131,972,0,0.03260178607627402,0.03260178607627402,0.018769454572194904,0.04726094181521865,0.04726094181521865,0,0.017942630337329395,0.017942630337329395,0,872,495,765,1436,832,0,408,223,1367,3033,631,164791,183086,156152
2023-02-27,61,13113,11026,2051,41996,27554,14731,43827,32130,17719,30747,22351,11314,1100,966,0,0.03260178607627402,0.03260178607627402,0.015005589115459649,0.04726094181521865,0.04726094181521865,0,0.017942630337329395,0.017942630337329395,0,886,488,635,1478,835,0,405,213,1374,2948,618,166165,186034,156770
2023-03-06,62,12723,10760,1823,43454,27882,14479,45285,32955,17744,31712,22059,10705,1068,960,0,0.03260178607627402,0.03260178607627402,0.011241723658724397,0.04726094181521865,0.04726094181521865,0,0.017942630337329395,0.017942630337329395,0,898,480,493,1518,837,0,401,203,1378,2848,604,167543,188882,157374
2023-03-13,63,12345,10518,1620,44868,28169,14210,46699,33755,17755,32787,21698,10069,1036,954,0,0.03260178607627402,0.03260178607627402,0.007477858201989138,0.04726094181521865,0.04726094181521865,0,0.017942630337329395,0.017942630337329395,0,909,472,339,1557,839,0,396,192,1381,2735,588,168924,191617,157962
2023-03-20,64,11977,10297,1440,46240,28420,13927,48071,34535,17754,33986,21272,9410,1004,948,0,0.03260178607627402,0.03260178607627402,0.0037139927452538857,0.04726094181521865,0.04726094181521865,0,0.017942630337329395,0.017942630337329395,0,918,463,173,1595,839,0,389,181,1381,2607,570,170305,194224,158532
2023-03-27,65,11618,10094,1280,47571,28638,13633,49402,35298,17745,35317,20785,8731,972,942,0,0.03260178607627402,0.03260178607627402,0,0.04726094181521865,0.04726094181521865,0,0.017942630337329395,0.017942630337329395,0,927,454,0,1632,839,0,382,169,1381,2471,551,171686,196695,159083
2023-04-03,66,11266,9908,1138,48863,28826,13331,50694,36047,17730,36609,20239,8034,940,936,0,0.03260178607627402,0.03260178607627402,0,0.04726094181521865,0.04726094181521865,0,0.017942630337329395,0.017942630337329395,0,934,444,0,1668,839,0,373,157,1378,2507,530,173064,199202,159613
2023-04-10,67,10922,9737,1011,50115,28987,13023,51946,36785,17713,37861,19636,7323,908,930,0,0.03260178607627402,0.03260178607627402,0,0.04726094181521865,0.04726094181521865,0,0.017942630337329395,0.017942630337329395,0,940,435,0,1704,838,0,363,144,1375,2542,507,174439,201744,160120
2023-04-17,68,10585,9579,899,51329,29124,12710,53160,37515,17694,39075,18980,6598,877,924,0,0.03260178607627402,0.03260178607627402,0,0.04726094181521865,0.04726094181521865,0,0.017942630337329395,0.017942630337329395,0,945,425,0,1738,837,0,352,131,1370,2575,483,175809,204319,160603
2023-04-24,69,10253,9432,799,52506,29240,12396,54337,38239,17676,40252,18272,5862,845,918,0,0.03260178607627402,0.03260178607627402,0,0.04726094181521865,0.04726094181521865,0,0.017942630337329395,0.017942630337329395,0,949,414,0,1773,836,0,341,118,1363,2609,459,177172,206928,161062
2023-05-01,70,9926,9295,710,53646,29336,12081,55477,38960,17660,41392,17514,5116,813,912,0,0.03260178607627402,0.03260178607627402,0,0.04726094181521865,0.04726094181521865,0,0.017942630337329395,0.017942630337329395,0,953,404,0,1807,835,0,328,105,1357,2642,433,178529,209570,161495
2023-05-08,71,9604,9168,631,54749,29413,11766,56580,39679,17647,42495,16706,4360,781,906,0,0.03260178607627402,0.03260178607627402,0,0.04726094181521865,0.04726094181521865,0,0.017942630337329395,0.017942630337329395,0,956,394,0,1841,835,0,314,92,1350,2676,406,179879,212246,161901
2023-05-15,72,9285,9049,561,55817,29473,11452,57648,40398,17639,43563,15850,3596,749,900,0,0.03260178607627402,0.03260178607627402,0,0.04726094181521865,0.04726094181521865,0,0.017942630337329395,0.017942630337329395,0,959,384,0,1875,834,0,300,78,1343,2709,378,181222,214955,162279
2023-05-22,73,8970,8937,499,56849,29518,11141,58680,41120,17636,44595,14947,2824,717,894,0,0.03260178607627402,0.03260178607627402,0,0.04726094181521865,0.04726094181521865,0,0.017942630337329395,0.017942630337329395,0,961,373,0,1909,834,0,284,65,1334,2743,349,182556,217698,162628
