Date,Week,Backlog of visa applications - Homes for Ukraine,Backlog of visa applications - Family Scheme,Backlog of visa applications - Super Sponsor,Backlog of visas issued - Homes for Ukraine,Backlog of visas issued - Family Scheme,Backlog of visas issued - Super Sponsor,Backlog of visas issued - Homes for Ukraine (upper bound),Backlog of visas issued - Family Scheme (upper bound),Backlog of visas issued - Super Sponsor (upper bound),Backlog of visas issued - Homes for Ukraine (lower bound),Backlog of visas issued - Family Scheme (lower bound),Backlog of visas issued - Super Sponsor (lower bound),Weekly applications - Homes for Ukraine,Weekly applications - Family Scheme,Arrival rate - Homes for Ukraine,Arrival rate - Family Scheme,Arrival rate - Super Sponsor,Arrival rate - Homes for Ukraine (upper bound),Arrival rate - Family Scheme (upper bound),Arrival rate - Super Sponsor (upper bound),Arrival rate - Homes for Ukraine (lower bound),Arrival rate - Family Scheme (lower bound),Arrival rate - Super Sponsor (lower bound),Weekly arrivals - Homes for Ukraine,Weekly arrivals - Family Scheme,Weekly arrivals - Super Sponsor,Weekly arrivals - Homes for Ukraine (upper bound),Weekly arrivals - Family Scheme (upper bound),Weekly arrivals - Super Sponsor (upper bound),Weekly arrivals - Homes for Ukraine (lower bound),Weekly arrivals - Family Scheme (lower bound),Weekly arrivals - Super Sponsor (lower bound),Weekly arrivals,Weekly arrivals (upper bound),Weekly arrivals (lower bound),Total arrivals,Total arrivals (upper bound),Total arrivals (lower bound)
2023-01-16,55,18757,16616,6243,24085,20598,15493,24455,20926,15754,23304,20269,15233,941,825,0.016766671738842647,0.031997613508406776,0.031997613508406776,0.05211936533874853,0.049193397886125645,0.049193397886125645,0,0.014801829130687911,0.014801829130687911,370,611,485,1151,940,745,0,283,224,1466,2836,507,156792,158162,155833
2023-01-23,56,17442,15471,5507,25952,21897,15733,26665,22584,16265,24309,21198,15194,895,813,0.01425168497816142,0.031997613508406776,0.031997613508406776,0.04926280351944119,0.049193397886125645,0.049193397886125645,0,0.014801829130687911,0.014801829130687911,343,659,496,1205,1029,775,0,300,225,1498,3009,525,158290,161171,156358
2023-01-30,57,16237,14450,4858,27702,23019,15879,28720,24093,16689,25127,21910,15043,850,802,0.011736698217480196,0.031997613508406776,0.031997613508406776,0.046406241700133855,0.049193397886125645,0.049193397886125645,0,0.014801829130687911,0.014801829130687911,305,701,503,1237,1111,800,0,314,225,1509,3148,539,159799,164319,156897
2023-02-06,58,15128,13538,4286,29360,23985,15943,30633,25472,17038,25789,22428,14794,804,791,0.00922171145679897,0.031997613508406776,0.031997613508406776,0.0435496798808265,0.049193397886125645,0.049193397886125645,0,0.014801829130687911,0.014801829130687911,255,737,508,1251,1185,821,0,324,223,1500,3257,547,161299,167576,157444
2023-02-13,59,14103,12722,3781,30946,24813,15938,32416,26735,17324,26325,22770,14461,758,779,0.006706724696117746,0.031997613508406776,0.031997613508406776,0.040693118061519165,0.049193397886125645,0.049193397886125645,0,0.014801829130687911,0.014801829130687911,197,767,510,1247,1253,838,0,332,219,1474,3338,551,162773,170914,157995
2023-02-20,60,13154,11991,3335,32478,25518,15874,34078,27897,17556,26760,22954,14055,713,768,0.00419173793543652,0.031997613508406776,0.031997613508406776,0.03783655624221182,0.049193397886125645,0.049193397886125645,0,0.014801829130687911,0.014801829130687911,130,794,510,1227,1315,852,0,337,214,1434,3394,551,164207,174308,158546
2023-02-27,61,12271,11334,2942,33974,26114,15759,35628,28970,17741,27118,22995,13584,667,756,0.0016767511747552946,0.031997613508406776,0.031997613508406776,0.034979994422904476,0.049193397886125645,0.049193397886125645,0,0.014801829130687911,0.014801829130687911,54,817,508,1192,1372,864,0,340,208,1379,3428,548,165586,177736,159094
2023-03-06,62,11447,10744,2595,35420,26613,15602,37074,29965,17887,27420,22905,13058,622,745,0,0.031997613508406776,0.031997613508406776,0.03212343260359713,0.049193397886125645,0.049193397886125645,0,0.014801829130687911,0.014801829130687911,0,836,504,1144,1425,873,0,340,201,1340,3442,541,166926,181178,159635
2023-03-13,63,10674,10212,2289,36769,27027,15409,38423,30892,18000,27684,22697,12484,576,734,0,0.031997613508406776,0.031997613508406776,0.029266870784289786,0.049193397886125645,0.049193397886125645,0,0.014801829130687911,0.014801829130687911,0,852,499,1085,1474,880,0,339,193,1351,3439,532,168277,184617,160167
2023-03-20,64,9947,9731,2019,38027,27365,15186,39681,31759,18085,27927,22380,11869,531,722,0,0.031997613508406776,0.031997613508406776,0.026410308964982445,0.049193397886125645,0.049193397886125645,0,0.014801829130687911,0.014801829130687911,0,865,493,1015,1520,885,0,336,185,1358,3420,521,169635,188037,160688
2023-03-27,65,9260,9295,1781,39199,27636,14938,40853,32575,18147,28164,21965,11217,485,711,0,0.031997613508406776,0.031997613508406776,0.023553747145675097,0.049193397886125645,0.049193397886125645,0,0.014801829130687911,0.014801829130687911,0,876,486,935,1562,890,0,331,176,1362,3387,507,170997,191424,161195
2023-04-03,66,8609,8899,1571,40290,27847,14670,41944,33345,18191,28409,21458,10534,440,699,0,0.031997613508406776,0.031997613508406776,0.02069718532636776,0.049193397886125645,0.049193397886125645,0,0.014801829130687911,0.014801829130687911,0,884,478,846,1602,893,0,325,166,1362,3341,491,172359,194765,161686
2023-04-10,67,7989,8538,1386,41304,28005,14386,42958,34076,18220,28675,20867,9824,394,688,0,0.031997613508406776,0.031997613508406776,0.01784062350706042,0.049193397886125645,0.049193397886125645,0,0.014801829130687911,0.014801829130687911,0,891,469,748,1640,895,0,318,156,1360,3283,474,173719,198048,162160
2023-04-17,68,7396,8208,1223,42245,28115,14089,43899,34773,18238,28972,20197,9091,348,676,0,0.031997613508406776,0.031997613508406776,0.014984061687753073,0.049193397886125645,0.049193397886125645,0,0.014801829130687911,0.014801829130687911,0,896,460,644,1676,896,0,309,145,1356,3216,454,175075,201264,162614
2023-04-24,69,6828,7906,1079,43116,28182,13782,44770,35441,18247,29311,19453,8338,303,665,0,0.031997613508406776,0.031997613508406776,0.012127499868445732,0.049193397886125645,0.049193397886125645,0,0.014801829130687911,0.014801829130687911,0,900,451,532,1711,897,0,299,135,1351,3140,434,176426,204404,163048
2023-05-01,70,6280,7628,952,43921,28212,13468,45575,36085,18251,29701,18642,7567,257,654,0,0.031997613508406776,0.031997613508406776,0.009270938049138387,0.049193397886125645,0.049193397886125645,0,0.014801829130687911,0.014801829130687911,0,902,441,415,1743,898,0,288,123,1343,3056,411,177769,207460,163459
2023-05-08,71,5752,7371,840,44661,28208,13149,46315,36708,18251,30149,17766,6781,212,642,0,0.031997613508406776,0.031997613508406776,0.006414376229831046,0.049193397886125645,0.049193397886125645,0,0.014801829130687911,0.014801829130687911,0,903,431,292,1775,898,0,276,112,1334,2965,388,179103,210425,163847
2023-05-15,72,5240,7133,741,45339,28174,12827,46993,37314,18250,30662,16829,5982,166,631,0,0.031997613508406776,0.031997613508406776,0.003557814410523698,0.049193397886125645,0.049193397886125645,0,0.014801829130687911,0.014801829130687911,0,903,421,165,1806,898,0,263,100,1324,2869,363,180427,213294,164210
2023-05-22,73,4744,6912,654,45956,28112,12504,47610,37905,18248,31246,15833,5171,121,619,0,0.031997613508406776,0.031997613508406776,7.012525912163531e-4,0.049193397886125645,0.049193397886125645,0,0.014801829130687911,0.014801829130687911,0,902,410,33,1836,898,0,249,89,1312,2767,338,181739,216061,164548
2023-05-29,74,4260,6706,577,46515,28026,12181,48169,38485,18248,31805,14782,4350,75,608,0,0.031997613508406776,0.031997613508406776,0,0.049193397886125645,0.049193397886125645,0,0.014801829130687911,0.014801829130687911,0,900,400,0,1865,898,0,234,77,1300,2763,311,183039,218824,164859
2023-06-05,75,3788,6513,509,47017,27919,11859,48671,39056,18252,32307,13679,3520,30,597,0,0.031997613508406776,0.031997613508406776,0,0.049193397886125645,0.049193397886125645,0,0.014801829130687911,0.014801829130687911,0,897,390,0,1893,898,0,219,64,1287,2791,283,184326,221615,165142
2023-06-12,76,3342,6331,449,47463,27793,11540,49117,39621,18260,32753,12525,2682,0,585,0,0.031997613508406776,0.031997613508406776,0,0.049193397886125645,0.049193397886125645,0,0.014801829130687911,0.014801829130687911,0,893,379,0,1921,898,0,202,52,1272,2819,254,185598,224434,165396
2023-06-19,77,2948,6159,396,47857,27650,11224,49511,40182,18273,33147,11322,1837,0,574,0,0.031997613508406776,0.031997613508406776,0,0.049193397886125645,0.049193397886125645,0,0.014801829130687911,0.014801829130687911,0,889,369,0,1949,898,0,185,40,1258,2847,225,186856,227281,165621
2023-06-26,78,2601,5995,349,48204,27491,10912,49858,40740,18293,33494,10071,985,0,562,0,0.031997613508406776,0.031997613508406776,0,0.049193397886125645,0.049193397886125645,0,0.014801829130687911,0.014801829130687911,0,885,359,0,1977,899,0,168,27,1244,2876,195,188100,230157,165816
