Date,Week,Backlog of visa applications - Homes for Ukraine,Backlog of visa applications - Family Scheme,Backlog of visa applications - Super Sponsor,Backlog of visas issued - Homes for Ukraine,Backlog of visas issued - Family Scheme,Backlog of visas issued - Super Sponsor,Backlog of visas issued - Homes for Ukraine (upper bound),Backlog of visas issued - Family Scheme (upper bound),Backlog of visas issued - Super Sponsor (upper bound),Backlog of visas issued - Homes for Ukraine (lower bound),Backlog of visas issued - Family Scheme (lower bound),Backlog of visas issued - Super Sponsor (lower bound),Weekly applications - Homes for Ukraine,Weekly applications - Family Scheme,Arrival rate - Homes for Ukraine,Arrival rate - Family Scheme,Arrival rate - Super Sponsor,Arrival rate - Homes for Ukraine (upper bound),Arrival rate - Family Scheme (upper bound),Arrival rate - Super Sponsor (upper bound),Arrival rate - Homes for Ukraine (lower bound),Arrival rate - Family Scheme (lower bound),Arrival rate - Super Sponsor (lower bound),Weekly arrivals - Homes for Ukraine,Weekly arrivals - Family Scheme,Weekly arrivals - Super Sponsor,Weekly arrivals - Homes for Ukraine (upper bound),Weekly arrivals - Family Scheme (upper bound),Weekly arrivals - Super Sponsor (upper bound),Weekly arrivals - Homes for Ukraine (lower bound),Weekly arrivals - Family Scheme (lower bound),Weekly arrivals - Super Sponsor (lower bound),Weekly arrivals,Weekly arrivals (upper bound),Weekly arrivals (lower bound),Total arrivals,Total arrivals (upper bound),Total arrivals (lower bound)
2023-02-13,59,18835,17559,5778,23770,20750,15451,24411,21031,15676,23011,20469,15226,0,0,0.029400440145826642,0.0312701811821909,0.0312701811821909,0.06425673254291829,0.04615910384785833,0.04615910384785833,0,0.016381258516523473,0.016381258516523473,641,591,473,1400,872,698,0,310,248,1705,2970,558,162948,164213,161801
2023-02-20,60,16536,15416,5073,25370,22244,15673,26710,22839,16132,23741,21641,15207,0,0,0.029400440145826642,0.0312701811821909,0.0312701811821909,0.06425673254291829,0.04615910384785833,0.04615910384785833,0,0.016381258516523473,0.016381258516523473,699,649,483,1569,971,724,0,335,249,1831,3264,584,164779,167477,162385
2023-02-27,61,14518,13534,4454,26642,23430,15802,28728,24366,16502,24043,22469,15081,0,0,0.029400440145826642,0.0312701811821909,0.0312701811821909,0.06425673254291829,0.04615910384785833,0.04615910384785833,0,0.016381258516523473,0.016381258516523473,746,696,490,1716,1054,745,0,355,249,1932,3515,604,166711,170992,162989
2023-03-06,62,12746,11882,3910,27631,24349,15852,30500,25650,16799,23969,22996,14863,0,0,0.029400440145826642,0.0312701811821909,0.0312701811821909,0.06425673254291829,0.04615910384785833,0.04615910384785833,0,0.016381258516523473,0.016381258516523473,783,733,494,1846,1125,762,0,368,247,2010,3733,615,168721,174725,163604
2023-03-13,63,11190,10432,3433,28375,25038,15833,32056,26723,17033,23565,23262,14565,0,0,0.029400440145826642,0.0312701811821909,0.0312701811821909,0.06425673254291829,0.04615910384785833,0.04615910384785833,0,0.016381258516523473,0.016381258516523473,812,761,496,1960,1184,775,0,377,243,2069,3919,620,170790,178644,164224
2023-03-20,64,9824,9159,3014,28907,25528,15757,33422,27615,17213,22871,23301,14198,0,0,0.029400440145826642,0.0312701811821909,0.0312701811821909,0.06425673254291829,0.04615910384785833,0.04615910384785833,0,0.016381258516523473,0.016381258516523473,834,783,495,2060,1234,786,0,381,239,2112,4080,620,172902,182724,164844
2023-03-27,65,8625,8041,2646,29256,25848,15632,34621,28351,17348,21922,23144,13771,0,0,0.029400440145826642,0.0312701811821909,0.0312701811821909,0.06425673254291829,0.04615910384785833,0.04615910384785833,0,0.016381258516523473,0.016381258516523473,850,798,493,2148,1275,795,0,382,233,2141,4218,615,175043,186942,165459
2023-04-03,66,7572,7060,2323,29449,26021,15466,35674,28953,17445,20750,22816,13293,0,0,0.029400440145826642,0.0312701811821909,0.0312701811821909,0.06425673254291829,0.04615910384785833,0.04615910384785833,0,0.016381258516523473,0.016381258516523473,860,808,489,2225,1309,801,0,379,226,2157,4335,605,177200,191277,166064
2023-04-10,67,6648,6198,2039,29507,26069,15266,36598,29441,17511,19382,22342,12772,0,0,0.029400440145826642,0.0312701811821909,0.0312701811821909,0.06425673254291829,0.04615910384785833,0.04615910384785833,0,0.016381258516523473,0.016381258516523473,866,814,484,2292,1336,805,0,374,218,2164,4433,592,179364,195710,166656
2023-04-17,68,5837,5442,1790,29450,26010,15038,37409,29831,17551,17841,21739,12213,0,0,0.029400440145826642,0.0312701811821909,0.0312701811821909,0.06425673254291829,0.04615910384785833,0.04615910384785833,0,0.016381258516523473,0.016381258516523473,868,815,477,2352,1359,808,0,366,209,2160,4519,575,181524,200229,167231
2023-04-24,69,5125,4778,1572,29296,25861,14786,38121,30139,17569,16149,21026,11621,0,0,0.029400440145826642,0.0312701811821909,0.0312701811821909,0.06425673254291829,0.04615910384785833,0.04615910384785833,0,0.016381258516523473,0.016381258516523473,866,813,470,2404,1377,810,0,356,200,2149,4591,556,183673,204820,167787
2023-05-01,70,4499,4195,1380,29061,25635,14516,38747,30378,17571,14325,20218,11002,0,0,0.029400440145826642,0.0312701811821909,0.0312701811821909,0.06425673254291829,0.04615910384785833,0.04615910384785833,0,0.016381258516523473,0.016381258516523473,861,809,462,2450,1391,811,0,344,190,2132,4652,534,185805,209472,168321
2023-05-08,71,3950,3683,1212,28756,25345,14230,39296,30559,17559,12384,19328,10359,0,0,0.029400440145826642,0.0312701811821909,0.0312701811821909,0.06425673254291829,0.04615910384785833,0.04615910384785833,0,0.016381258516523473,0.016381258516523473,854,802,454,2490,1402,811,0,331,180,2110,4703,511,187915,214175,168832
2023-05-15,72,3468,3233,1064,28393,25002,13933,39778,30692,17537,10341,18367,9696,0,0,0.029400440145826642,0.0312701811821909,0.0312701811821909,0.06425673254291829,0.04615910384785833,0.04615910384785833,0,0.016381258516523473,0.016381258516523473,845,793,445,2525,1411,811,0,317,170,2083,4747,487,189998,218922,169319
2023-05-22,73,3045,2838,934,27981,24615,13627,40201,30786,17508,8208,17345,9017,0,0,0.029400440145826642,0.0312701811821909,0.0312701811821909,0.06425673254291829,0.04615910384785833,0.04615910384785833,0,0.016381258516523473,0.016381258516523473,835,782,436,2556,1417,809,0,301,159,2053,4782,460,192051,223704,169779
2023-05-29,74,2673,2492,820,27530,24191,13315,40573,30848,17474,5997,16270,8323,0,0,0.029400440145826642,0.0312701811821909,0.0312701811821909,0.06425673254291829,0.04615910384785833,0.04615910384785833,0,0.016381258516523473,0.016381258516523473,823,770,426,2583,1421,808,0,284,148,2019,4812,432,194070,228516,170211
2023-06-05,75,2347,2188,720,27047,23739,12999,40899,30885,17438,3716,15150,7616,0,0,0.029400440145826642,0.0312701811821909,0.0312701811821909,0.06425673254291829,0.04615910384785833,0.04615910384785833,0,0.016381258516523473,0.016381258516523473,809,756,416,2607,1424,807,0,267,136,1981,4838,403,196051,233354,170614
2023-06-12,76,2061,1921,632,26538,23264,12681,41185,30904,17401,1374,13991,6899,0,0,0.029400440145826642,0.0312701811821909,0.0312701811821909,0.06425673254291829,0.04615910384785833,0.04615910384785833,0,0.016381258516523473,0.016381258516523473,795,742,406,2628,1426,805,0,248,125,1943,4859,373,197994,238213,170987
2023-06-19,77,1809,1687,555,26010,22771,12361,41437,30909,17365,252,12798,6173,0,0,0.029400440145826642,0.0312701811821909,0.0312701811821909,0.06425673254291829,0.04615910384785833,0.04615910384785833,0,0.016381258516523473,0.016381258516523473,780,727,397,2646,1427,803,0,229,113,1904,4876,342,199898,243089,171329
2023-06-26,78,1588,1481,487,25466,22265,12042,41658,30905,17332,221,11577,5439,0,0,0.029400440145826642,0.0312701811821909,0.0312701811821909,0.06425673254291829,0.04615910384785833,0.04615910384785833,0,0.016381258516523473,0.016381258516523473,765,712,387,2663,1427,802,0,210,101,1864,4892,311,201762,247981,171640
2023-07-03,79,1394,1300,428,24911,21750,11724,41852,30896,17302,194,10331,4698,0,0,0.029400440145826642,0.0312701811821909,0.0312701811821909,0.06425673254291829,0.04615910384785833,0.04615910384785833,0,0.016381258516523473,0.016381258516523473,749,696,377,2677,1427,800,0,190,89,1822,4904,279,203584,252885,171919
2023-07-10,80,1224,1141,376,24349,21229,11409,42022,30886,17277,170,9064,3951,0,0,0.029400440145826642,0.0312701811821909,0.0312701811821909,0.06425673254291829,0.04615910384785833,0.04615910384785833,0,0.016381258516523473,0.016381258516523473,732,680,367,2689,1426,799,0,169,77,1779,4914,246,205363,257799,172165
2023-07-17,81,1075,1002,330,23782,20704,11098,42171,30877,17258,149,7777,3200,0,0,0.029400440145826642,0.0312701811821909,0.0312701811821909,0.06425673254291829,0.04615910384785833,0.04615910384785833,0,0.016381258516523473,0.016381258516523473,716,664,357,2700,1426,797,0,148,65,1737,4923,213,207100,262722,172378
2023-07-24,82,944,880,290,23214,20179,10791,42302,30872,17246,131,6474,2443,0,0,0.029400440145826642,0.0312701811821909,0.0312701811821909,0.06425673254291829,0.04615910384785833,0.04615910384785833,0,0.016381258516523473,0.016381258516523473,699,647,347,2710,1425,797,0,127,52,1693,4932,179,208793,267654,172557
