Date,Week,Backlog of visa applications - Homes for Ukraine,Backlog of visa applications - Family Scheme,Backlog of visa applications - Super Sponsor,Backlog of visas issued - Homes for Ukraine,Backlog of visas issued - Family Scheme,Backlog of visas issued - Super Sponsor,Backlog of visas issued - Homes for Ukraine (upper bound),Backlog of visas issued - Family Scheme (upper bound),Backlog of visas issued - Super Sponsor (upper bound),Backlog of visas issued - Homes for Ukraine (lower bound),Backlog of visas issued - Family Scheme (lower bound),Backlog of visas issued - Super Sponsor (lower bound),Weekly applications - Homes for Ukraine,Weekly applications - Family Scheme,Arrival rate - Homes for Ukraine,Arrival rate - Family Scheme,Arrival rate - Super Sponsor,Arrival rate - Homes for Ukraine (upper bound),Arrival rate - Family Scheme (upper bound),Arrival rate - Super Sponsor (upper bound),Arrival rate - Homes for Ukraine (lower bound),Arrival rate - Family Scheme (lower bound),Arrival rate - Super Sponsor (lower bound),Weekly arrivals - Homes for Ukraine,Weekly arrivals - Family Scheme,Weekly arrivals - Super Sponsor,Weekly arrivals - Homes for Ukraine (upper bound),Weekly arrivals - Family Scheme (upper bound),Weekly arrivals - Super Sponsor (upper bound),Weekly arrivals - Homes for Ukraine (lower bound),Weekly arrivals - Family Scheme (lower bound),Weekly arrivals - Super Sponsor (lower bound),Weekly arrivals,Weekly arrivals (upper bound),Weekly arrivals (lower bound),Total arrivals,Total arrivals (upper bound),Total arrivals (lower bound)
2023-01-23,56,18264,15826,6164,23791,20669,15489,24134,20976,15732,23019,20362,15246,0,0,0.015875182452630275,0.031661881764101014,0.031661881764101014,0.05157608080341307,0.047725980868003344,0.047725980868003344,0,0.015597782660198685,0.015597782660198685,343,605,479,1115,912,722,0,298,236,1427,2749,534,158384,159706,157491
2023-01-30,57,16058,13915,5420,25679,21926,15743,26340,22569,16238,24049,21272,15239,0,0,0.013380162766331374,0.031661881764101014,0.031661881764101014,0.048712986586968904,0.047725980868003344,0.047725980868003344,0,0.015597782660198685,0.015597782660198685,318,654,490,1176,1001,751,0,318,238,1462,2928,556,159846,162634,158047
2023-02-06,58,14119,12235,4765,27338,22912,15900,28279,23917,16655,24780,21875,15119,0,0,0.010885143080032474,0.031661881764101014,0.031661881764101014,0.04584989237052474,0.047725980868003344,0.047725980868003344,0,0.015597782660198685,0.015597782660198685,280,694,498,1208,1077,775,0,332,238,1472,3060,570,161318,165694,158617
2023-02-13,59,12414,10757,4190,28814,23665,15972,29984,25054,16994,25269,22212,14899,0,0,0.008390123393733573,0.031661881764101014,0.031661881764101014,0.042986798154080574,0.047725980868003344,0.047725980868003344,0,0.015597782660198685,0.015597782660198685,229,725,503,1216,1141,795,0,341,236,1457,3152,577,162775,168846,159194
2023-02-20,60,10915,9458,3684,30143,24215,15972,31483,26007,17268,25565,22315,14594,0,0,0.005895103707434665,0.031661881764101014,0.031661881764101014,0.0401237039376364,0.047725980868003344,0.047725980868003344,0,0.015597782660198685,0.015597782660198685,170,749,506,1203,1196,811,0,346,232,1425,3210,578,164200,172056,159772
2023-02-27,61,9597,8316,3239,31359,24590,15911,32801,26801,17485,25710,22216,14215,0,0,0.0034000840211357714,0.031661881764101014,0.031661881764101014,0.037260609721192245,0.047725980868003344,0.047725980868003344,0,0.015597782660198685,0.015597782660198685,102,767,506,1173,1241,824,0,348,228,1375,3238,576,165575,175294,160348
2023-03-06,62,8438,7312,2848,32490,24815,15798,33960,27458,17654,25741,21941,13772,0,0,9.050643348368775e-4,0.031661881764101014,0.031661881764101014,0.03439751550474809,0.047725980868003344,0.047725980868003344,0,0.015597782660198685,0.015597782660198685,28,779,504,1128,1279,834,0,347,222,1311,3241,569,166886,178535,160917
2023-03-13,63,7419,6429,2504,33509,24912,15642,34979,27999,17783,25689,21514,13273,0,0,0,0.031661881764101014,0.031661881764101014,0.031534421288303915,0.047725980868003344,0.047725980868003344,0,0.015597782660198685,0.015597782660198685,0,786,500,1071,1310,843,0,342,215,1286,3224,557,168172,181759,161474
2023-03-20,64,6523,5653,2202,34405,24899,15449,35875,28439,17878,25582,20954,12726,0,0,0,0.031661881764101014,0.031661881764101014,0.028671327071859744,0.047725980868003344,0.047725980868003344,0,0.015597782660198685,0.015597782660198685,0,789,495,1003,1336,849,0,336,207,1284,3188,543,169456,184947,162017
2023-03-27,65,5735,4970,1936,35193,24794,15226,36663,28795,17946,25444,20280,12139,0,0,0,0.031661881764101014,0.031661881764101014,0.025808232855415586,0.047725980868003344,0.047725980868003344,0,0.015597782660198685,0.015597782660198685,0,788,489,926,1357,853,0,327,198,1277,3136,525,170733,188083,162542
2023-04-03,66,5042,4370,1702,35886,24609,14978,37356,29079,17991,25296,19506,11517,0,0,0,0.031661881764101014,0.031661881764101014,0.022945138638971428,0.047725980868003344,0.047725980868003344,0,0.015597782660198685,0.015597782660198685,0,785,482,841,1374,856,0,316,189,1267,3071,505,172000,191154,163047
2023-04-10,67,4433,3842,1496,36495,24358,14710,37965,29303,18017,25155,18646,10864,0,0,0,0.031661881764101014,0.031661881764101014,0.020082044422527263,0.047725980868003344,0.047725980868003344,0,0.015597782660198685,0.015597782660198685,0,779,474,750,1388,859,0,304,180,1253,2997,484,173253,194151,163531
2023-04-17,68,3898,3378,1315,37030,24051,14425,38500,29476,18029,25036,17711,10185,0,0,0,0.031661881764101014,0.031661881764101014,0.017218950206083085,0.047725980868003344,0.047725980868003344,0,0.015597782660198685,0.015597782660198685,0,771,466,654,1399,860,0,291,169,1237,2913,460,174490,197064,163991
2023-04-24,69,3427,2970,1156,37501,23698,14127,38971,29608,18029,24954,16712,9484,0,0,0,0.031661881764101014,0.031661881764101014,0.01435585598963893,0.047725980868003344,0.047725980868003344,0,0.015597782660198685,0.015597782660198685,0,761,457,553,1407,860,0,276,159,1218,2820,435,175708,199884,164426
2023-05-01,70,3013,2611,1016,37915,23307,13820,39385,29706,18021,24920,15658,8764,0,0,0,0.031661881764101014,0.031661881764101014,0.011492761773194773,0.047725980868003344,0.047725980868003344,0,0.015597782660198685,0.015597782660198685,0,750,447,448,1413,860,0,261,148,1197,2721,409,176905,202605,164835
2023-05-08,71,2649,2296,893,38279,22884,13505,39749,29777,18007,24944,14555,8027,0,0,0,0.031661881764101014,0.031661881764101014,0.008629667556750598,0.047725980868003344,0.047725980868003344,0,0.015597782660198685,0.015597782660198685,0,738,438,340,1418,860,0,244,137,1176,2618,381,178081,205223,165216
2023-05-15,72,2329,2019,785,38599,22436,13185,40069,29827,17990,25035,13411,7276,0,0,0,0.031661881764101014,0.031661881764101014,0.005766573340306429,0.047725980868003344,0.047725980868003344,0,0.015597782660198685,0.015597782660198685,0,725,428,229,1421,859,0,227,125,1153,2509,352,179234,207732,165568
2023-05-22,73,2048,1775,690,38880,21970,12863,40350,29862,17972,25200,12231,6512,0,0,0,0.031661881764101014,0.031661881764101014,0.002903479123862268,0.047725980868003344,0.047725980868003344,0,0.015597782660198685,0.015597782660198685,0,710,417,116,1424,859,0,209,113,1127,2399,322,180361,210131,165890
2023-05-29,74,1801,1561,607,39127,21488,12539,40597,29885,17953,25445,11020,5737,0,0,0,0.031661881764101014,0.031661881764101014,4.038490741811382e-5,0.047725980868003344,0.047725980868003344,0,0.015597782660198685,0.015597782660198685,0,696,407,2,1425,858,0,191,102,1103,2285,293,181464,212416,166183
2023-06-05,75,1584,1372,534,39344,20997,12215,40814,29902,17937,25662,9783,4953,0,0,0,0.031661881764101014,0.031661881764101014,0,0.047725980868003344,0.047725980868003344,0,0.015597782660198685,0.015597782660198685,0,680,397,0,1426,857,0,172,89,1077,2283,261,182541,214699,166444
2023-06-12,76,1393,1206,470,39535,20498,11892,41005,29915,17924,25853,8522,4161,0,0,0,0.031661881764101014,0.031661881764101014,0,0.047725980868003344,0.047725980868003344,0,0.015597782660198685,0.015597782660198685,0,665,387,0,1427,856,0,153,77,1052,2283,230,183593,216982,166674
2023-06-19,77,1225,1060,413,39703,19995,11572,41173,29928,17916,26021,7240,3363,0,0,0,0.031661881764101014,0.031661881764101014,0,0.047725980868003344,0.047725980868003344,0,0.015597782660198685,0.015597782660198685,0,649,377,0,1428,855,0,133,65,1026,2283,198,184619,219265,166872
2023-06-26,78,1077,932,363,39851,19490,11256,41321,29943,17914,26169,5940,2558,0,0,0,0.031661881764101014,0.031661881764101014,0,0.047725980868003344,0.047725980868003344,0,0.015597782660198685,0.015597782660198685,0,633,366,0,1428,855,0,113,52,999,2283,165,185618,221548,167037
2023-07-03,79,947,819,319,39981,18986,10944,41451,29963,17918,26299,4624,1747,0,0,0,0.031661881764101014,0.031661881764101014,0,0.047725980868003344,0.047725980868003344,0,0.015597782660198685,0.015597782660198685,0,617,356,0,1429,855,0,93,40,973,2284,133,186591,223832,167170
